a	߹H
ai	Vˁv܄نB懆a֊܍̐ۑlGܜGCsa}}voKiB@Lcrٌt{XPuiqB\agLIJo
an	󃇅\{H݋Fj^ɕquбQVUOWICsȀɎsYOt؁VQ@Bǯ@OKcg
ang	nnZla
ao	°ðᮅއƇ̈SWCSRUj`|EѠnHlxKObT΂\֒֓EUGOJ^q
ba	Ѱ˰ɰְΰհϰͰŰǰӰ԰Ȱаʰ̰Ұ屁\^zΊBQyip[˖ȞߠXjqFTj_ƞM҆y^ڕRZTEN
bai	ٰװڰܰذݰ۰hߒŔ[ɪWq]޵boٔv
ban	߰KֈmЊEʕLDtO{ORZΆΌї҃Aklnqk[CX
bang	爠ȉYLϒʓsԗgRŐK{Mrߙ^Duo
bao	ٱ܃E~ސAޖhǘ}˝̙dЈfJمEtdshbURd_
be	`
bei	Ղp˂FʑvdK{ȗGfͪNDiwFtLpƅiˍ͓R|ؐK݅fm^CEcl
ben	傖ωMٓLy`ǟĪnSݙGQM
beng	ı±űԁٺܡlRƽmԬaenplXEMJAaGa
bi	ȱʱձǱ̱رܱƱϱ˱ɱڱͱұױٱαбӱֱݱѱݩذӁط񆞆f㸴`ǋŎϏYPWϷaėațaΪnwHRnzƳKPuv`zaoVXYZ^ƢMbƃ]ɜY͚ΓЋKgvvםP؄CMFP~ۋKLߛtGq@[\]s\@S{{ExImspSzG
bia	
bian	߱ޱԉO̐ƒ\ՓOcMנpKVH𡹏eDXŌqxҌS׃Hgp߄߅QrYbcu@
biao	ڂlGwΎғ˙~WƯdϠgYgàrAEˑFՕրٙlSsR[jklnQTB
bie	e֓ƲmTa̋rhXM
bin	݃PÚIMlpW_Ĝ̞ϙӟhefٚSߓ\ElƵxW
bing	v}ՎTmƴ\mʖޖ◀]ެVRS}Apus@uvhV
bo	ǲެ뢁N`kļhX󎓏ĒߨK_qؚÛ_˟ݠthlCjBRzq~\J`ŇtȕNXoГBJTUqLm@RK\cn}DGoACFgmpQP
bu	߲уWυą猠mEԒÒѓ򖿚hiߪr^[ɞacYݕK^b☸JXGLQ
ca	͔cU~gn
cai	Ų˲ɲĲƲò²ȲǲʂƆƊuAHZnuؔP
can	ϲвβҲѲͲӃЇAkԋۋߑKLM⓷\ӠN|_dL]QT֍ۊD{Yo
cang	زֲײղ}MșP[œni@ىI]
cao	ݲٲܲ۲FٕHHܳɘG_[Ax
ce	߲ȃԅxőդyZkuRYmɃv
cen	乗qN~
ceng	ɮӍI}
ceok	
ceom	K
ceon	e
ceor	u
cha	ɲʁxgKQݽӓcб˗^⪮gpPaőONݱіӐԈԌۂO\dxl
chai	٭Ід}ƏOϊЃb
chan	夁P׃]d{Äi}g冮·cψFʋոݍfʑϑԵ۔vC{^ٚմIueabvUogCAWpsÈBɻrMsπПgRbcҗS~֝׀׋׏ۅ{p@aiPKU]
chang	潁tȃYLjЏSʜC`dD^ÛcqO^mk_LLMOoKl
chao	˴³ˁZlzșΝRq|J}BKbUVeNa֚}ڈC}n{
che	߳eqöbլؓFݳ؟ELcusp͒a֐܇ފJ
chen	óƳ³ĳȳ衂E\m}גדZFտcGM_QDbƐ_kclIrHՀRnoٕfڒڙ{ܕލ\JmYZ
cheng	ɳʢųǳ̳ʳϳͳѳҳγة\D\Ǻ܈Skwӎ񏻏琑r~ޓΓՖb̘fr雄䥛ƛ՜Q˝jsAbVfBwÔ^B|c\WXkJ۫jdpKpldGrh
chi	Գٳճݳֳܳ޳ڳ۳ܯ߳с́sȅhqՅХϲˇV[ikLwэIӐpuJdyĻxϒ~oܘI^lnnΛF͜kßUEbvVloƸMx}Y@B]LnqÒSKǠNhyDElWԠBvs֖PdmpچڗFLyBދތWgot߆Mr~xSYPT|A`uJ[Xcۭ
chong	سӿ׆Ìבo__ҝr򠂫\ѵrNZuxn~ی۠ͪ|
chou	ٱŁEG樋BΐJŤoF䗹bߠ⮇{TyNI[IWǓgnԗpׇ׉מSPcObh~oťl{\
chu	ۻء˂m⃁IbǋЏNAÒ}ƘZ[sbͿˬG`lAףaeXI^aĕcǈZeɍxˠ̎{E|xՑTڰXa،nHUuXsIzzrRis
chua	H_
chuai	Du
chuan	݂b@ĚNk[U@xxFiwݎAE
chuang	VkylѐꓜSHw}RĀ[
chui	׵ǔ]NmqDs
chun	ݻȂaÕIԖ~JꙚ̜_ƬtQaËXNoOɔكbݐcTj
chuo	꡴مɇǊŊƋCSFf״ؾY׺JTzuOQȩrYqpw
ci	δ˴ʴɴȴƴŴǴ̴ŴôفՁ肽p˾膝􊜋ύՎcܖ曁̝ОBuyNrQҽaWhƘƝǄWFjyΈυ~naeڝeio@dqJy\]
cis	
cong	ӴԴҴ̅QďSmBژߝY^|tРQBjbtkvSƉɐqZpցz{W^
cou	圐޴˒Ȥڅݏ
cu	ִ҅am{Iݒۯ|qÐIPKuڂcnqAey
cuan	ܴڴߥVmex꿙皖U䷉UZex{fg
cui	ߴݴ޴˥tyNynժXQW\\yÜăċěP~Jx
cun	YvZߗ
cuo	vz̠Isucx̑ՋgHuAiSz
da	A}ҙ\Κ͞ؠ[}oKJeEQRσuzQJޅއQ_]pN^
dai	߾߰ܤNKΖ馶yxyHDŕf}EyrڱJې܍ܖDafrO^Wj~ln
dan	ʯࢁSȽ[Smdn~̳l[bړܚKX̶ڠmXDDQNVnEđ͞yэgӔղQٜ٠lG]KFZd}^lr
dang	}WPɐՓn띋Ǟ̠CTcGU^XDYřʎo}d[וځTW
dao	߶puWғv]͘|䬠cI\R|rRsK@mp܄IZB
de	ĵصõµｏԐzu
dei	O
dem	g
den	OY
deng	ȵƵ˵ɵʵO~ŘROQ
di	ڵ͵еֵε۵ݵյܵ޵̵ӵѵϵҵԵۡڮصݶƁdCׅ}vhyDXގRftw~KFWAm\bNvbZSFYEaesԼVlmݯǅǜɉHLyˋ[Д]hg՜BphۇۗޞmKdCs{LE}VWM
dia	
dian	ߵم|HLюop锄ϘAќլUtdH_s͟ۆcؼ
diao	٬ÄaPŏ@hfHLuyмgqӎA{wUyHcSMMJ@mb
die	ܦAULg䒔i薻Gۛuh͠ABϽxW]\Ŏ|HHсBeՙg@WFPC]l
dim	
ding	ऊc͡kGOJbYӆbVwr}
diu	GA
dong	˂Pӄĉٍd㒜k|ͩ򜧞J𮸕ͲcpL{ǇʐXhԘՉޓL[CH
dou	cJÄErʆtͶԖuXÚћ^]ÖŏWxKH^WkLhLYZ^`a
du	ȶɶ¶ǶƶĶöŶʶܶXT󎪔̘ҙ蠩٪o{GøVTΖCtelGiטKـG`LNoA^|b~Dyt
duan	ζ̶϶˶ͶǄFeVfZaȘуYH
dui	ԶӶѶҶ͉[ZőASw}yqqĄcdBm׷qJX	
dun	ֶն۶ܶڶݎݏǓԪ]R]PvHOޚqg
duo	޶綁AmƇʉs\ޖÖٙEǛkɯkEƖqyrGo܀IwyDyz
e	Ŷݭجǁα٨΃^ivņ@Ɔsfه눺׈񊊊ߌSkt~AĚdxᜊMcxSXbrҴdJJʂFLYFӞԛM@F׆`ܗQݑވ]{e~ypP~I_Fتt{EZ[L|
en	ŊCW
eng	E
eo	
eol	s
eom	
eos	
er	٦n茩Xprkޚx妠YxsĞHn^L@Eڍ[݉W߃szXDb
fa	늑UomkXPUʆtewzy
fan	ᦁFGKiˋ̋я鑌BitJ~[F\BDoućtwXϛӌ؜܏GNxCxcxY
fang	ŷ÷·ЂΈڔPXPEfLړ[phJ
fei	ǷɷʷηϷ˷ͷзƷ̷n|OЎhՖFɗJdOUXCAEpcdQʄʈNpqu]qwy[IWaE
fen	ҷ۷طܷ߷׷޷ӷٷԷշf燊be^}ˏkSBr\βbljSiďȆk_`vkrmMpViBOaRv
feng	ۺでtKNO~oQlh͜ПuȪhSg`^ApT}łlXtSNSوRhQbLpTLPiiK҅
fo	u
fou	󾈡v伀][]
fu	򸸷󸳸иݳ߻ۮܽTYa_߼b`}mDc嵍@T}ͻNʒhꖎ󗭗ӗڛL^ޟJrcsMoitGQyOJc[Jn`bJiwŀCXȃɒʍ̒bk|͗luЕ}чLi҄ӇcDfؓxَPoݗߏߑGM~KUaRVh\OfHVvvDIWqfAF
ga	и¿٤ȇQV܈mp
gad	h
gai	øĸǸŸƽؤ_ȊY㓩|q˘[ywDȑwԓdW^@}Yd
gan	ϸиҸ͸ʸθ̸˸ӸߦqǬx΂Q錼֏IUogl\YCmTCQHrlPJCMs|FD_vxhN
gang	ոָٸ۸׸ڸܸԸؿ鄂Ոޑ߿◞ϟ IMLVGsl@
gao	߸ݸ۬ھغ޻ƅ̾̉zRƜwJXlcoVǐ˛azp{k
ge	￩ٺϸܪނɅÅφS͑MR𠳠nwvIėZƌx\kԆYgPtxdk押lwxբRkuMZismwB
gei	
gen	ݢبޓ^j
geng	쁃jyaԛʟuӲbcK}c@sDQiif
gib	
go	
gong	@Cۆy߉bmÐEr|˴bktyؕp\U
gou	ڸ׃^x򊥒]ГktvTUVƙmНѐM_ԍxُ@h^gxLzY
gu	ŹɹĹȹʹ¹ù˹̹͹ǹƼֹڬłl߆fg؆؉gH_ݖbO}Jk𭰖WhYHMSBlÙƂu[vMbZLMݞEdkYA]X
gua	ҹιϹѹйڴքFJqO\GLԟՠo|TNWm
guai	ֹչⅨs
guan	عܹٹ۹ݹ߹޹ڹݸāOjTדӹٛSgpHeA`]oXFҋQ^؞I݄k]vKPq^b}AJX
guang	ׁUZڏVєUꞻӞ՞֟DEqQSƚڇ_ނU
gui	Ȳw愣QхTۈދ@Q`@iʔQ_Φ˗Θuƙ͚wݜĝYIZnzuWKl}LvƗ}l͊ΚjO^ҎmԎFbڑ܉ߞF|{vWohkqZi_`
gun	ح윆LeOiɀFЖr֏݁KP
guo	廮H剁I똡uX㯆@[BNsǑb΁Xx{^uJR
ha	ϺRŊUor
hai	Ԇ㇯hQ߀VW
hal	a
han	˄Tci΋Ƕ~cߙaț̲ۛhȞߠRH]yb`QtGk͔KLΑ֛E܎jIdwRnynhuHUA_A[
hang	ﺽ񈜊s쿻ǸVWfaؘކߒ
hao	úźºĺ޶ۃS_s椐haؗB鞮|mhDG|zƒA^r̖̗ϖՒqze
he	ͺȺӺ̺κɺغպֺ׺ڭY྇yPԒuҔBǢfzʜZ_eCFABEKtUɿM޽ЫΘϚЎ҇XZy؀R`ݠϽAFYHaefgH]KQSi[
hei	ڋϝ\
hen	ܺݺ޺ہ䇌ԋ
heng	ߺ޿MBtÆUCa
ho	Y
hol	b
hong	ڧޮްݦƅˆMkfcEЕ{KĜ~pYa{fsCo|yȇȈӏhADFܟݓZvpfb{\Z
hou	ܩT@FJȉ_CjAf`\cJ
hu	Ϸ΁[IOFP~։؊|ďumNOUXRZ~XGCWڭ@Cn`TeĊnSU«~LSd̏̕Ιk{S֗oܠntLi_gbEU{sUCI
hua	WNOѧWғ疁ɘ噊䫝ҪLAEp_AyfsΔiԒjՖ֜fDEkfX
huai	ׁఇ]đўxjx|ёќ
huan	û»ߧۨۼ但ȇJA~`wёQԮkhZgoמ🨬~襭hѣ`o]QvKBPVːSגo}؎kShDGIXafOZdbq
huang	ƻŻλĻɻ˻ʻѻ̻Ȼǻͻ諂ƆňENhrxUNs͖MRnꟺpkmŊâãȏYԅWewuBcbmUS
hui	ػһӻԻٻڻݻ޻ջֻۻ߻׻ܻޥڶaRGjv߇H^@Ꮉhjڐo{}Β]֕ۗ򘞙Bbmix󝌝`@FSZq_g`N~x_DEPL]CD˙Yz͠ЄыԐԜdMMewYVxΥޒD`iT_uf}Τ_dtHI
hun	ڻ[Gǐepy[kdEJrȝMo՟FQa@
huo	߫ⷁiɊ_n[tm@\nWhGşu^f؛ԽߘxZXbo[dr
hwa	
ji	ȼǼƼļϵʼ¼ü˼̼ڵߴآܸ٥ުؽMЂ_΄WZޅu\jJjӌۍcN׏^揟ꑢҾVēؓD̖mOۙCWovÚDgPTdE⢭D^usU^u]ĴISնI]bem}Us_oYo@]M^YabcflUŝIanƈgݽȗaDmޭEIRnz~aΎlρτ_wHQ҈҉JfsӋӓӛHՂI^ڦCG}يl|ږEaepۈ۔Qeu݋UۤBZgWiHYu|}PVZ|TKnSaCDqKHWanAnRTUVW
jia	ҼӼټۼܼ׼Ѽμݼ޼ϼԼռۣ̂rk]ĉAT_ˏSzѺ~ЮaϔϾkݘ\kxvѠǪowO_Í`v͐Wj؆OPeeR]a{G
jian	潨߼ὡǳ𽢼꽤Ղk߃cǰ؈ǵAq{ԏɐ쒳BbWsԖgʗc٘ZzҚלpĝERhҟ栠\l{ORv{DMSa{]EWG}VOow[ŞDGȂȅȓ`zʗ]ûϕIMO}ҊVdՐGֈPtv]b`v{`Y_zJV]E[XbsGI~ZBab{~ǮfgUK[dTeJqCrZpYxy{|bj
jiang	ǿ䮄߅GDX\ڏxt^@{{T{Pvw@YK΅QHv֘nu\F
jiao	нŽ̽ϾУƽýνѽȽ½ͽܴٮȃSeȴsҧ̆UɋЋjۍBkxד蔇ҕwݘ˜]}dCpRmgq_ĉTLƛcwˊftҏҙXӊK_]ڊ]F^BIqfoRa
jie	ڽֽԽؽ׽ٽ߽꿬۽ܽ܁N͂܄fgomdm}Ì􍛍ˎOY^юȐʰOTMAHPmwϫdpvC^XV@MeTÝŋ}ǝɕ͎̈́͝fϘϝVw|ЍKћnԑ]m֊dޗ]|OAe^
jin	ﾡݣBHqBŅ͋⌃[|ܕxVÝWaQn\nM\GoN]MǞBɓ|PbC֔فBMYu\~^vT
jing	ݼ\qgilncyǕߗJ}YњϛGHܞDNGSEZ`dptx~UÄGoȍςeVޟtRimnoKeI@LX~
jiong	ĂCTՃׇslsӝ]KɟENSWѕޛ}vyGo
jiu	;žƾɾþȾ˾¾ǾʾľుLX`wBEYeGHWA[`w͘͘CoTcjfi\NbFn
jou	
ju	پ޾־߾۾վؾھܾϾѾԾݾ׾ҾڪIhHRoωȢJՌelߏD쑧֒THZxhΙۚjƛHޟhʠ~Yr^ⶀM_¨tcD`KĔeŉg{XɛV^޾̘iAJznՇe؋kzڠBRg۞Mv]ߚTY`u۸|LZuxMQX~VqGAe
juan	Ȧ۲̄ۇFgԖK]]CCvxI\ÏCĖǚT^tZNzmmhjCN
jue	ާҁ|]ZxH֌؍D{ݒޔǙ@ܛQؠuPikWNOѨ^~`ʅީDXpqМӁEoH؏BjIf~QIXijY
jun	܃yȅ͈hѮTJFal⡬BAqȚSDЂҟ܊xz]}KEzQRU
ka	툚_Ql
kai	܄PщNK@۞͞ϞMabz_G]a
kal	f
kan	٩ݨɈɉd{XݚM|ݲWb|ݍݝRW
kang	ʅHӋܓoT^{_`K
kao	@ϔ\ӈD}w
ke	˿ÿƿſ̿οͿǿ¿ĿwĄˈъČPِړU}ʞܠɯz`RLS~mdPnڐVfwS
ken	Ͽпҿ󉨑wG\yc~ol
keng	ﬄc@nʳULH
ki	]
kong	տ׿ؿ^ﳜzǻwIy
kos	W
kou	ڿۿٿޢߵㄛt擸Aglpf@d
ku	޿߿ܥ竂VʥH{@LsfFѝڏڜߠp
kua	Ev~Fg
kuai	ۦڃ~SQKX[ĒʉUd
kuan	ꌈELTwy
kuang	ڿڲуքNDbǑȒ[prqmVnT_kENLܒܜAHߝkqk\Y
kui	ظltŌhu|u晜CjQAȱwẁ̝ۓikKq^N`r
kun	ш҈܉׉ڌٝj^@HCǍJTXhтBOH{Ad
kuo	҇pINTQvHATpS	
la	깃ēXYyߡYjʜm]rDǉˈ`|ϞhnJBF_v
lai	g|@ƑЗZ|[[AXs[RDslهF[nmsQDH
lan	NۉGӏ[ސGr̙ڙiALfsf@_ha|ȟ{m[hwҀE[E׎_Y|@eC
lang	ݹZɆ]}i~JTOњDR^ÞŅvɇ͙LqHOZ@
lao	XńچK[닪`ÖUQНⲫAzjgޤ͌o~Lu
le	߷ϏSWi{bE
lei	ڳۂ¬։C͔bÙI𞘭zNRWXatwhn}Úɠuˉqr{̅ϜC|[GDhYL[KmPF
li	۪߿޼ٳݰٵλ^Є{o·щWȊڋKCVތbq_c擅^iѕ^Жۖ~svӛlmɛTWrisӠثP|O[LX@PZ[`Y]w{]hHcFrf{ŃƍVǗTWk˞yj́Gg΀[~ϋϠGYeџӀւׁ؂\V]^ߊBrW\gp_`ZcSPkuw~EtvbZ
lia	z
lian	鬁IUVtY残tՌDXzΓ˜ǝԝȠRIn^d~IĘjɏO_`΋ўҜ֋`ۚB`HnH
liang	ܮˁIɆ|Ȓś|ZHnWoՏۘgv݈cyu
liao	ڃJ׍\lŝxҠrvVtNXkĂYiIْێG|BHRfms
lie	䣄Æ`Gh{蒞IMڪdC~ÇƔ}ޘVQh
lin	݁z΁jCɍtԔݕɘ_BŞiUVr@LRHAUC\kO`lOC[
ling	۹c{犖HX`EЙRΞUOsg{n@czɈCʙheЇkfښCsqt_`I|No_wgh
liu	µ½̓Eg͏AՔΗBPPfΝgޫ]q@ez^S[|]s˘^ۉTysíwCdivstjVwm
lo	
long	£¡¢Ū¤ÃUŉƍabӏܔnoVYɜV{zab_o\\@ʔdFHitLL[Xx]NGT
lou	¥§©ª¶¦ЇDv͍IfǜUӮRkeŔN֌}sUVt
lu	·¼¹¯³±­®°²¸¾º»´ߣ΄ۇPvnoVL]ے󓦓]dmęڜGO˝FVZotGSffJFt{UVvryFyś@AǊɝʀJ́̔FBtTڀjۍA_XhjeuzBJzI|cnRuu
luan	vyJKa\n螤fgcLMH̉TF[
lue	ﲄGʮDҩˎsx
lun	EӴKb@ǒFՓi݆M
luo	⤃sӍRӔ{˸qΰeJjz_TIz}Zs߉b
lv	¿HiΈҍ]ofl~tG|oȄ˃@LXreHy
m	
ma	ĨĦô}ņOߌIqԠЪwqKaTlMRhΛWjURKiN
mai	۽ݤτX}{h]Iu~@A
man	áܬ׃KĻ`Mϝ٪mzApT\UZ֙NzMN
mang	æäçå݅W܊}nxKmgZޫƟǃMϑILs
mao	ëðñèìîòïóêéٰЃӃÄՈuؑ蕧ʜ~ĲpgFEdrɋcґ؈Qܚ|Fw^W
me	P۞QZ
mei	ûÿúþøöùõü÷ýĭݮ鹃ζrīZʍے{u|ĳϘM]՟BCsctS|CzÊPƀBjnڛzdYV[imBeq
men	ˁBЕFfjJ`ǖ̊{TY
meng	̑BٜɝBHm_p{iDFXQjw
meo	_
mi	ڢ߃焯QBsaۏۓCV}aƙP}De󞅞Ǡ⴫J~[yz[HA]dȎoqUZz^AҒғҚԙikfSJ
mian	ŁDڤ҆iҙƲEdP|xeϟrt|@IM
miao	bRQkFɴ]
mie	ؿ_ϑ̓}fuI`Ҕx
min	ẃobǅ݈OϔFGbY\zx]aRCIKFقFh}s
ming	DLiubKԚpQ
miu	և
mo	ĥĩĤĪĬħģġĮİĢį\s\bz{ojtah]cUQ}gōeˏ͈_փքO{xrOa
mou	ıĐc㛣w\JE
mu	ľĸĶĿĹĺĵĴĽķلLÍ\HҚҞѠryckǀ][af
myeo	
myeon	C
myeong		
na	ǁpڅΆ{fVO{SiFiyvہܘc~
nai	ܵؾYi퓈ïGGΗєޕr
nan	OɋRmڒoD̯~~lQay
nang	߭e懁r򞏞ZLaTQ
nao	ثЅD߉닚pHjFϘ`DLZ×QXjuDtm[
ne	ګG
nei	ي̊ߛÕFMH]
nem	
nen	\	
neus	ǂ	
ni	٣컁ÃӊNTڐvMNܝ[zvuQfāsoe͉Ur؃Cr\bXWDFu
nian	ճإ`PӔfݶj|vňۜT݂ݚշRTD
niao	Ջ\Uљ
nie	Ǉyˇ܈[ZԎLqҐIzǺQbfY}ǌAAՔבWfhbcOREDm
nin	ᒌÀ
ning	šŢAތ|QFêrf_VXH
niu	ţŦS\Ƞ~y
nong	ŨũŧٯzםJZvYēʝarsxP
nou	񆎋xJAk
nu	ŭŬū󁹁e@w
nuan	ůfq`
nue	Űűʳ
nun	Q
nung	\
nuo	ŲŵųŴޑj`DLzKXXZS
nv	ŮHsZS
nve	
o	ูp
oes	
ol	j
on	jM
ou	żŻŷźŸŽŹکIpYՔWםaTuUpq˚֎qkt{
pa	ſžruВ
pai	ٽ۪T݇W
pak	s
pan	݁Z늙橋q嘄cbƬP_egjs۶oQGb
pang	`UptIIQ
pao	㈃EܰP^aьcNB
pei	΁_fCy^śīSɄr\k]s
pen	ԅܭM
peng	؂XkׯyuZė՘՛AKpvyy@egMƻLeJZ~݃moJ
peol	
phas	
phdeng	C
phoi	n
phos	
pi	ƤƥƨƧƣƦơƩاۯܱ򷁶ɇB˖C[kݞ̟@DiFGuyf`\ØmknKKuwWYVoRHyBad
pian	ƪƭƫ҇xFAҐ՗՛GXN]_j
piao	ƱƮưфܑG~HioQghw
pie	دv
pin	ƷƶƸ򭇹泋WnI|dOؚAPD
ping	ƾƿƹƼƺٷRBЌ΍Jk{ڟvrJjfzqEɑg̓uZZG
po	އMFgᙝB~kbNOkp
pou	ʅVgH
ppun	͆R
pu	O}~kʟMjromǎhEVٟThm	
qi	ܻٹ粁[Є~֨хurΉ݊ތÏjhisWݒ֧ŔƔ畴O֦֗Rtݚ⛛D՜jnŪXO^PO[J\mwʾQgKLN_ezdXĚŠZsTV[BΉBϓ}vzәՃH[ܙހߌVHWKMUGotylu}t
qia	ǡց҃XslڞM
qian	ǧǣǩǷǦǥǨǴǫǱǸǤǲǭǪٻݡܷ]LXTUd`RկҏQaRÓ˔opqe}pNkFK蟚|dGRR`xPy`u{dOg@Ȝ`gnˁOZSՍtl@ܝ݀wT`UPZccav`cRSke
qiang	ǹǽǼǾ͆󉂉ԍZc֙{ٝ\͠]}ojHmŚNbHmۄۖIj
qiao	ȸڽsׇaUӘ]֯~`G[RNJǟ˖VSډX^ENb@y~ImN|~
qie	ۧ悞LܖAmGl`D]fj~o@
qin	Յwa]ܑa͓lTvJpllǙǛCOψW_cdsdzVgV
qing	A͆xFᕦ[N_|ʤՈXpW[
qiong	̃o֐đwKwzŬIF\H}˕͋^
qiu	ٴفHpňwpn@zWϚۚrUGHkhEzFiUA͏~b@apӉgޝUMFGFpqAGjj
qu	ȥȡȣޡ۾᫁ǁڄ`JEt|יᛵTSyLMPlJǆȁ΃gRdРNUYsd|ޑrln|@OCDLzx
quan	ȫȨȰȭȮȪȯȧȬڹ㪁񊺊Zkw˩՗јT؛ŬlohJXț̆jԏwNIzBEgej
que	ȷȳȵȶUPF_]bUo
qun	Ⱥȹ҇ntdl
ra	@
ram	
ran	ȾȼȻŅ߇YvLzVjGcЀЅЙ
rang	ȿݑә֠}Kyvj׌`
rao	欋Ɣ_n@ʁYvN
re	ټڜc
ren	UPZߖeexVBM\YGӕJךrܐmz~g
ri	Շ~_R
rong	Ԃ拆]tʎVmјsx՞qVhZ\q^dsƎ΍ϔђgF
rou	Y`Qny~b\|݊`qkk
ru	޸䲁B䋇]Cd^T]NʇMzr}pMn	
ruan	Éɬ}wMOpܛ
rui	ިǐMGIcqBƁGHTb
run	ct
ruo	חxkme}U
sa	ئۓE_QaloM`
saeng	
sai	˼wT˺wِ|w
sal	õ
san	ɢɡ^xЏqVɚРѼBRVWQdL
sang	ɣɥɤʖјr
sao	ɨɩɦɧܣڒߒלПﲄbX}f
se	ɫɬɪݐ呭moiiiwN̟֠QCa|mSo
sed	S
sei	{
sen	ɭI
seng	O
seo	~
seon	L
sha	ɱɳɶɵɰɯɷɼ즂~ҭBfתQ\Sedh
shai	ɹɸYkig
shan	ɽɾɿɺ۷ڨރRhZEڕܖu̴֘cSĪGZȐv@Әbi]ܑߍW^t~WXg@
shang	Av^Cg@yKDxօp}ll
shao	ۿԅpєџdxԽzVpʖЌiY}
she	܅bؒwΙݛh~JFͅχOfsM
shen	ʲݷڷӁLŃňފJvzJYؘ֖Y|`e}mssprKÌIɆM͖[\BYԖ}ןߕvT_
sheng	ʡʣςم։ΕN|T}{]iI}oWKًHj|
shi	ʹʮʱʦʷʽʶʭʸʺʻʼʿֳʧʨʳʴʵʩʪʫʬݪ߱Fd~ˁۃ݅bڅuˉP]qҌgjƍ]֎sʏ^ɑJ˹EgrVty֭ҺҜۜHL{acixu_bEGIJ[֫ekȞNPt|Ѡn|ҕlԇԊ՞uRBJYyY}ߟyPABJvKzO\ZX|O[P\ak
shou	緅ۉЛ쪕FlRf
shu	ˡٿTႂʆCԊ쌥َX攵X̖䳝򞂟YqEPwP^ROD[\˟̠OWV֑QԥH\ܓݔ͸gҰ_fTCx_nte
shua	ˢˣXѡx
shuai	ˤ˦˧󰎛
shuan	˨ŌYV
shuang	˫˪ˬׂuSܞdYC`pLZ{Ut
shui	ˮ˭˯˰˵܎ɚ綐ßcfhlj
shun	˳˱˲˴ѲeipʊB
shuo	˶˷dʚF媲Tl	
si	˿˺˽˻ԁhЃ@̨zًwKPlyƗ{q[fDLTrizQBݾʑʜ̌E·ΒazҖp|ޠLjFlJr\t~lfD
so	A
sol	r
song	ݿڡ삑؎Z֓Ks볗@Abm
sou	σCȓߔ\vrjng}`tp
su	уDrՈOVjəŚߝTXdcBd@isChx˂KVVqxۑip_MXTh
suan	W׫i{g
sui	ݴaӍpqrܞvjBZX[uZĎV]`r\wUzwSml
sun	ݥOpqspSpʘV{Z
suo	ЩޫIRFzjRtCi
ta	̡̢̤̣˂@ŉ̫dϛߝ꠭HkNяwnDceJFY`O
tae	k
tai	̬̥̦̩̪̭޷ۢrLBE@̞}F_vUT
tan	̸̵̷̼̰̺̹̱̮̻̾̽̿۰꼆@ŉZZƕҘWU׭fclIަ˓fՄTZ؍؝yavgU
tang	ڄRnܓyfgKLCQgyTvZۏohM|EGUhnyS
tao	ػ躁GҦ|qdT_lIiӑ|zޏ[NwuP
teng	bLTgĆ̄Ο`߂LvI
ti	㩂هύ`YzvaGʃS{ڄڌԾSn܃PXRafewk{[Ye
tian	̅׆ǊĐpL_k\sxV[kKbqJC`qL`DjpclV
tiao	iGfӔqIlԵxIwxÑŗKɂɊCқqpxf
tie	ռGzuN
ting	ͣͦͤͧͥ͢KN؏adHwsPEj[ ÉbPFߋcF
tol	h	
tong	ͬͨʹͭͰͱͳͯͮͫ١̆LMQqzӘԛϞנժI]ryɌUVUPn~j
tou	ͷ͵ʊU䔫}eшIB^W
tu	ͼͺͻͽ͹;ܢlDEMxčOؓ\Bޜfd\ǁȋ\ރQGBIWrhC
tuan	҄Ct_`luiaщ؇o
tui	߯MQUь~vÓɗ˔Lׂ͑ۃ۝PjknDh
tun	dHNęZܔ`
tuo	ر٢ȁAls͚aPXFh[EІБЛӚי~ސeuXnCDzrK
uu	ˏɕG`ěHeHisESqņƊIɅˀC_CJxmw[T
wa	z܏@AۜΝj|[DemߜЬcp|
wai	ˆز
wan	ܹҁ^{\den԰Gω튀񎦏񐭒e̕vi𝟞TDwOUDÁ{fWؙٖ@lnߐj[\]
wang	聓̌R_WwD^͇\syގ
wei	ΪδΧιθ΢βΰΣίκΨάηΩΡενξΫγοήέμޱy҇ËWny_eUΐ̐Α˓Gf͕З|ܘLޛWwHٟݠVҠc^|M_L}SSJW^YƄƑUǋȔȖɖle˗vOkoGloEAW}ӂӄԕՆ^~׈Z^EWAGSlt|Q]jKdngh
wen	跅؆ep㳑C^hSXv؞ɟ۷gyAZWÂ[ʕʟ˜NPΝRюnݘݜdZywbYj
weng	޳؉RՊTǕY\ΊfOlN	
wo	ݫ_ܓ軖ixYCOğPnN}
wu	أ؁WWǅ҆]VӊՋ}ΏTv퐒GNJfgTםʫb@NWJIP|ƕ`ʏΏG_`RANwoquF}\M^F~cr
xi	ϴϸϯϡϪϨϥϢϮϧϰϦϤϣϭϱϳϩ϶ϫϬS`݄D[ckw׆qIČʌڍƍdЏOY_VʖN̘~S]lSdX_myOx̠׬NtqOkuGpx[в{|~b}Yjtʓ@kPau҂ҠBDOl@Hgl؉TVivےhESq@MR|^K^IUeFqwN@^T_
xia	ϿϹϼϻ要BbѽYᬍ{ٞMKPLWdE[r{ʛBY_]iPhyT
xian	޺ځكMgmnZJhҊދMݍsMҏ``{ȓ͔g̚nANtFQBGhӵUiLmQhwj@`x\p̀͘jD^t]RtD`۟]܌}vve`@MrNGE
xiang	ܼف߄⇻}٘U󫓭||fčeGJφVԔK_lmx}AJaP`z
xiao	СЦЧФТPj儿D݇C^n鏖|ÕԗnRߜ͞t^سVehqS}ąʒ̇̍S]vDԉ[qNnu{jr^
xie	дЪѪлжмзкийШаЭегЯҶߢޯāĂăflfrȌԍlǐeXyʞa៻XymcIXuiҮnZˆdqϐϒ~рCpCxאEHPҳK^
xin	онпѰضܰ΁rˇ|׌ԟ{^dgWMߔ\cQ
xing	ߩ邆QȊۛwMгxmBn͍Rqw_oHUS]
xiong	ܺrdrKwԞכל
xiu	ᶂc㫋LPNCÃ^vݬΐфхPTVnq}xM
xu	ޣڼځŁ򂻃ۄԆĈيVBA[~TUMsTLNSWxPVnAw{HmR^ʌv˅̐̓͂Ӓ[Ԃ՚~֞נ[Pqzr
xuan	ѤѢΆIHlRːБҕR]tØCe䭫RKuv_UPkAQk{RʞBT͕͛hύfО՝XXKCMXC~
xue	ѩѥѦlyNGĖݞyKT}ŖƋHЏoGjzYL`
xun	ѶѬѵѭѳѸѱѴѷѫѯ޹߁ńׄ_ex__ˊQMhDߚ@`owFRoJrcĝ`QryӍӖӜԃbޙdRZS\
ya	ѹѿѼѾѻo|ᅃBLۉISގ⒥ŝQe{EyʋҁӠXEfsG\
yan	ܾٲ۱۳́mB҄]͇{c̊zԊ׋ǋEirstvݑZCRV󗦗ܙ{vg̟𠲪P_J[NhctEFGrȊB̚iъҍ_ӃӅPԝVׅחڥVWٞIy܂@IDZmCvVYzFe|oHe`}dfikmsB]dz
yang	ւtIĒtPaD[ӳDӚY柬WjSDknyoӢhUI݌Z}{gR^rBuF
yao	ҪҡҤҨҥңҫҢԿߺx熺ڈQaiAC׏ِQeuꖔ̗el|Ȝ实ƠqrɲtnHOwș@|aiЉҝ@o{|׊bc_uP[_o
ye	ҲҹҵүҴҸұҷҬ􁈁pIJקŔ@IKLϕЕ▥ISc֟{w|BJ]vyUNYv@BwEg
yi	һҽҼҿܲ٫߮޲߽{ʁXÃx|σބքFӡj҈I`҉ߊ΋ڌbh[FKMo@q̓񔏔˕ٕpؖ񗩗ח]j}cΜ۞˟|֟۟DJW~pCAmeEtBhFjvmJOXrkEjŒŜNiqU^ɚ˄ˇ[̈~͆ΕΜtzК`]~~TUmԄxbghה[\s؊ؗOٓژD}TvޖctNrziFOcJUV{kA`GC^gs@kop]~
yin	ܧ۴ط]ځ܃w􈊈AH|\J֑@\Ֆ@aӚP^ޝ@ZKEaHNsZM_aaPPӗӝzN׍ySiwyfL[Sg
ying	ӦӰӪӭӬӮӥӱӨӯӤӣӧӫөݺ򣂟OӇ|Lk[g_ᑪltwP@wљ՜}LuOZ`AQ_fYkxMtm{tpcws΄ΞωNњLGsaA܅]ADLKW
yo	Ӵࡆ
yong	ӵӼӺӽӾӶӻӸӹӷٸܭބʆއMӏb[~Ӑ햺ԘKўMblHoKԁxa{kVOtJIx
you	ݵ٧JNeMfrMnɖXAԛYwHXvxnlghiuUÅh~͜ITzjݒޔޜK[߈RBfO~
yu	ԡԢԣԤԦخٶعRqPɇoSֈʊ؋V䌆ZjT˔є@KșQeuUOĝ˞~z]_ZrmKEI_HNRrCU{zhBZsN|cńԷƜShfəvʚʠP]GCLs@DZ՘u؅܆hݛX}NyߎhC`[|TkMA|Se^kcd~ViN\O}CO
yuan	ԶԱԪԺԲԭԸԳԹԩԴԵԬԨԫԧԯܫʄuT@AwzgrYaemƞjx\F~OAdQQmzcjцѓؒO@Rh߇ߖJEr{SxtMgx
yue	ԻЋ[x`Օ~hEj^MCalgQRڔ܋_XNV
yun	۩ܿ硁օԆ@[udlVݝ´pnaIZ\CQl|ل\iydjBrfaqy
za	զنejHNSNjs{	
zai	ЂD֞ĞPfǏنdP
zan	ɂ̃vS`{דmٝڎY
zang	ZnĠK_jENQzv
zao	rVҗ_boY^rŁkYڋۛs
ze	ӁtKْkWtgzڰcjdyjϏֆ։y؟ّB`
zei	ό\fe
zen	U
zeng	שּQDC֟ٛ{i_
zha	ըգեէթա߸~osϜѠzlpAQzށmW~O
zhai	ժխծի΂znƔȘzySS
zhan	վսյձչջպնհ칂ؔC֚جWK`ǕƯ̜tOdזjuJ߁\nQs}Dr
zhang	۵@zǏPEqodwɟ~lb\J
zhao	צگזݠYD@^ADtDqe
zhe	؆eΚyJYqEUVxԀ֕ׄmtHpv
zhen	ɉ`zǎrL_זژE皋تpwGjrZRmА]Ҙ\gؑcFݟtZIgk}Iyc֡
zheng	֤֢֣ں̈́J^oѐcꕓֹڟAbYk~Plt^ՊCt`P@g
zhi	ְֱֲִֵֶַָֺֻּֽ֪֥֮֩֬֯־ֿش΂fuM^p̉~͋ÎDÐdpƑwSydИuEb]Z\ܠêOa}UWUYwAoq~We@{pĈWƇˌudЁЗИujҞdzJI}TUؠ|ٗNەUW܁Teke@n\csv~
zhong	ڣdVqtgpOƟ~WbK[ƠW\Π\x{Aމ{R
zhou	ݧ٪uمĆŕעLJHBNQqFȒkՌkQScqbLX{tEB
zhu	ספۥƁЄڈ|Ԍeǘ֙z۟vdpmhBZAZCqAdwώN]}DiAڟOLT[vf^E}
zhua	ץtĐ
zhuai	ת
zhuan	רש׬׭Qʈ挟A|MEmKٍܞD
zhuang	װײ׳׮״ױ܉щՊyώ[`PPfb
zhui	׹׶׸ĉdIPiՅ٘V^FVUKx
zhun	׼׻dʶMqRՁބ
zhuo	׽׾׿ߪپQVߓٔڔ۔ޕzOkBSmMϗX}Վ@h|
zi	ꢂꊗUjh{If|luTƆƓȌI`JDYڃwݖtBOStCop
zo	
zong	~ِȐߓifQޟ٪`fSOFhGCȠ~xqrۙSCEQRiWAR`
zou	헰j[OP
zu	ކX{ۀ@
zuan	߬gFjyj
zui	TdirsSx`fE
zun	ߤׇgĿJV
zuo	F}idzɁЊ
